B             B          B
B                 B      B
B                     B  B
B                        B
B         BB            BB
B     BB      BB      BBBB
B                 BB     B
B   B                    B
BP BBB                   B
BBBBBBBBBBBBBBBBBBBBBBBBBB
